"filename", "language", "C++", "C", "comment", "blank", "total"
"/home/moonixiali/Documents/OpenGL-Projects/TestingGL/src/components/animation_component.h", "C++", 6, 0, 0, 1, 7
"/home/moonixiali/Documents/OpenGL-Projects/TestingGL/src/components/camera_component.h", "C++", 7, 0, 0, 1, 8
"/home/moonixiali/Documents/OpenGL-Projects/TestingGL/src/components/component_set.h", "C++", 70, 0, 3, 15, 88
"/home/moonixiali/Documents/OpenGL-Projects/TestingGL/src/components/physics_component.h", "C++", 6, 0, 0, 1, 7
"/home/moonixiali/Documents/OpenGL-Projects/TestingGL/src/components/render_component.h", "C++", 6, 0, 0, 1, 7
"/home/moonixiali/Documents/OpenGL-Projects/TestingGL/src/components/transform_component.h", "C++", 6, 0, 0, 1, 7
"/home/moonixiali/Documents/OpenGL-Projects/TestingGL/src/config.cpp", "C++", 16, 0, 0, 4, 20
"/home/moonixiali/Documents/OpenGL-Projects/TestingGL/src/config.h", "C++", 26, 0, 0, 9, 35
"/home/moonixiali/Documents/OpenGL-Projects/TestingGL/src/controller/app.cpp", "C++", 111, 0, 3, 28, 142
"/home/moonixiali/Documents/OpenGL-Projects/TestingGL/src/controller/app.h", "C++", 40, 0, 4, 12, 56
"/home/moonixiali/Documents/OpenGL-Projects/TestingGL/src/factories/factory.cpp", "C++", 84, 0, 0, 24, 108
"/home/moonixiali/Documents/OpenGL-Projects/TestingGL/src/factories/factory.h", "C++", 34, 0, 0, 12, 46
"/home/moonixiali/Documents/OpenGL-Projects/TestingGL/src/factories/mesh_factory.cpp", "C++", 160, 0, 6, 50, 216
"/home/moonixiali/Documents/OpenGL-Projects/TestingGL/src/factories/mesh_factory.h", "C++", 31, 0, 0, 12, 43
"/home/moonixiali/Documents/OpenGL-Projects/TestingGL/src/factories/texture_factory.cpp", "C++", 43, 0, 7, 15, 65
"/home/moonixiali/Documents/OpenGL-Projects/TestingGL/src/factories/texture_factory.h", "C++", 12, 0, 0, 10, 22
"/home/moonixiali/Documents/OpenGL-Projects/TestingGL/src/glad.c", "C", 0, 9038, 641, 47, 9726
"/home/moonixiali/Documents/OpenGL-Projects/TestingGL/src/main.cpp", "C++", 31, 0, 0, 15, 46
"/home/moonixiali/Documents/OpenGL-Projects/TestingGL/src/stb_image.h", "C++", 5842, 0, 1285, 861, 7988
"/home/moonixiali/Documents/OpenGL-Projects/TestingGL/src/systems/animation_system.cpp", "C++", 12, 0, 0, 5, 17
"/home/moonixiali/Documents/OpenGL-Projects/TestingGL/src/systems/animation_system.h", "C++", 11, 0, 0, 4, 15
"/home/moonixiali/Documents/OpenGL-Projects/TestingGL/src/systems/camera_system.cpp", "C++", 109, 0, 11, 26, 146
"/home/moonixiali/Documents/OpenGL-Projects/TestingGL/src/systems/camera_system.h", "C++", 23, 0, 0, 5, 28
"/home/moonixiali/Documents/OpenGL-Projects/TestingGL/src/systems/motion_system.cpp", "C++", 19, 0, 0, 6, 25
"/home/moonixiali/Documents/OpenGL-Projects/TestingGL/src/systems/motion_system.h", "C++", 15, 0, 0, 5, 20
"/home/moonixiali/Documents/OpenGL-Projects/TestingGL/src/systems/render_system.cpp", "C++", 242, 0, 20, 39, 301
"/home/moonixiali/Documents/OpenGL-Projects/TestingGL/src/systems/render_system.h", "C++", 37, 0, 2, 9, 48
"/home/moonixiali/Documents/OpenGL-Projects/TestingGL/src/view/shader.cpp", "C++", 47, 0, 7, 15, 69
"/home/moonixiali/Documents/OpenGL-Projects/TestingGL/src/view/shader.h", "C++", 5, 0, 0, 2, 7
"Total", "-", 7051, 9038, 1989, 1235, 19313